Teams,Zone,TotalMatches,MatchesWon,MatchesLost,WinPercent
Mumbai Indians,West,120,80,40,66.67
Chennai Super Kings,South,90,70,20,77.78
Kolkata Knight Riders,East,110,60,50,54.55
Royal Challengers Bangalore,South,100,40,60,40
Rajasthan Royals,West,80,50,30,62.5
Sunrisers Hyderabad,South,100,50,50,50
Delhi Capitals,North,110,60,50,54.55
Lucknow Super Giants,North,50,25,25,50
Punjab Kings,North,90,40,50,44.44
Gujarat Titans,West,60,30,30,50