Teams,Zone,TotalMatches,MatchesWon,MatchesLost,WinPercent
Mumbai indians,west,120,80,40,66.67
Chennai super kings,SOUTH,90,70,20,77.78
Kolkata knight riders,east,110,60,50,54.55
Royal challengers bangalore,SOUTH,100,40,60,40
Rajasthan royals,west,80,50,30,62.5
Sun risers hyderabad,SOUTH,100,50,50,50
Delhi capitals,NORTH,110,60,50,54.55
Lucknow super giants,NORTH,50,25,25,50
Punjab kings,NORTH,90,40,50,44.44
Gujarat titans,west,60,30,30,50